as	wie
each	jeder
can	können
I	ich
you	du
word	Wort
to	zu
time	Zeit
will	Wille
at	bei
it	es
an	ein
by	bei
for	für
in	in
on	auf
with	mit
from	von
and	und
but	aber
the	der
do	tun
be	sein
other	andere
tell	erzählen
have	haben
if	wenn
that	jener
a	ein
of	von
some	einige
or	oder
hot	heiß
is	ist
out	hinaus
how	wie
had	gehabt
one	eins
said	sagen
are	Ar
he	er
they	sie
this	dieser
what	was
which	welcher
his	sein
we	wir
their	ihr
were	waren
was	war
change	ändern
end	Ende
air	Luft
point	Punkt
kind	Art
well	Brunnen
us	ich
try	probieren
want	Mangel
again	erneut
earth	Erde
home	Haus
land	Land
near	nahe
off	aus
picture	Bild
play	spielen
put	setzen
set	Menge
even	gerade
why	aber ja
follow	folgen
read	lesen
spell	buchstabieren
ask	fragen
add	hinzufügen
build	erbauen
house	Haus
act	Akt
father	Papa
world	Erde
light	Licht
high	hoch
port	Hafen
large	groß
hand	Hand
men	Männer
need	brauchen
also	auch
small	klein
big	groß
animal	Lebewesen
here	hier
mother	Mutter
must	müssen
such	solch
three	drei
self	Selbst
went	gingen
any	irgendein
every	jeder
form	Form
good	gut
great	groß
right	gerade
me	mich
turn	drehen
name	Name
show	anzeigen
take	nehmen
back	zurück
much	anders
through	durch
very	ganz
work	Arbeit
get	bekommen
part	Anteil
give	geben
old	betagt
round	abgerundet
cause	Grund
move	bewegen
sentence	Ausspruch
help	helfen
line	Linie
think	denken
mean	bedeuten
say	aussprechen
low	leise
place	legen
differ	abweichen
just	gerade
same	gleich
live	leben
only	einzig
too	auch
under	darunter
man	Mann
after	nach
boy	Junge
little	klein
before	bevor
she	er
where	irgendwo
new	neu
made	hergestellt
came	kam
year	Jahr
our	mein
all	ganz
look	schauen
may	dürfen
now	nun
sound	klingen
then	dann
her	ihr
way	Weg
find	finden
more	mehr
side	Seite
no	nein
go	gehen
use	benutzen
write	schreiben
make	machen
come	kommen
like	wie
see	sehen
down	herunter
call	rufen
thing	Ding
up	hinauf
people	Leute
than	als
when	wann
so	so
most	meist
about	ungefähr
long	lang
first	erst
water	Wasser
know	kennen
number	Zahl
day	Tag
over	über
two	beide
him	ihn
there	da
who	wer
your	dein
these	diese
them	sie
many	viele
been	gewesen
has	hat
would	wollte
could	kann
my	mein
did	Tat
never	nie
close	schließen
left	links
study	studieren
cross	Kreuz
press	Presse
start	anfangen
state	Staat
far	fern
country	Land
thought	Gedanke
cover	bedecken
night	Nacht
still	noch
while	solange
run	laufen
late	spät
own	besitzen
keep	behalten
draw	Remis
answer	antworten
plant	Pflanze
school	Schule
head	Kopf
real	echt
stand	stehen
farm	Bauernhof
grow	anbauen
last	dauern
story	Geschichte
found	gründen
hard	hart
might	Macht
food	Essen
north	Norden
eye	Auge
tree	Baum
life	Lebensdauer
between	dazwischen
learn	lernen
let	lassen
few	einige
page	Seite
city	Stadt
should	sollen
sun	Sonne
saw	Säge
sea	Meer
stop	aufhören
face	Gesicht
idea	Idee
mark	Zeichen
white	weiß
cut	schneiden
got	abgekriegt
paper	Papier
carry	tragen
ease	erleichtern
base	Base
main	hauptsächlich
example	Beispiel
group	Gruppe
often	oft
care	Sorge
watch	Uhr
friend	Freund
book	Buch
both	beide
always	immer
sure	sicher
together	zusammen
letter	Brief
once	einmal
begin	anfangen
next	nächst
second	Sekunde
open	offen
fish	Fisch
seem	scheinen
mountain	Berg
hear	hören
color	Farbe
wood	Holz
mile	Meile
walk	gehen
car	Auto
children	Kinder
river	Fluss
began	begann
science	Wissenschaft
until	bis
horse	Pferd
those	jene
eat	essen
feet	Füße
room	Zimmer
took	nahm
music	Musik
whole	ganz
complete	komplett
leave	lassen
enough	genug
talk	sprechen
body	Körper
since	seit
area	Fläche
fire	Feuer
ship	Schiff
order	Befehl
question	Frage
pass	Pass
happen	geschehen
measure	messen
pose	posieren
feel	fühlen
list	Liste
young	jung
family	Familie
top	Spitze
piece	Stück
problem	Problem
wind	aufwickeln
class	Schicht
ready	fertig
plain	Ebene
direct	direkt
street	Straße
though	obwohl
usual	gewöhnlich
soon	bald
song	Lied
product	Produkt
above	über
rock	Fels
door	Tür
short	kurz
girl	Mädchen
dog	Hund
told	gesagt
half	Hälfte
bird	Braut
black	schwarz
king	König
ever	jemals
knew	gewusst
south	Süden
red	rot
numeral	Numerale
tire	Reifen
full	voll
language	Sprache
decide	entscheiden
deep	tief
gold	Gold
snow	Schnee
check	prüfen
yes	ja
test	Test
fill	füllen
distant	fern
plane	Ebene
course	Kurs
object	Objekt
force	Kraft
possible	möglich
common	gemeinsam
stay	bleiben
dry	trocken
record	Schallplatte
among	unter
bring	bringen
nothing	nichts
paint	malen
system	System
surface	Oberfläche
multiply	multiplizieren
blue	blau
shape	Form
game	Spiel
east	Osten
heat	Hitze
miss	verfehlen
laugh	lachen
foot	Fuß
contain	enthalten
busy	beschäftigt
wonder	Wunder
ago	vor
brought	gebracht
wheel	Rad
boat	Boot
inch	Zoll
moon	Mond
island	Insel
ran	gelaufen
equate	gleichsetzen
stead	Stelle
thousand	tausend
drive	fahren
best	bester
certain	sicher
fine	Geldstrafe
fall	fallen
power	Macht
space	Raum
correct	richtig
figure	Abbildung
plan	Plan
clear	klar
fly	Fliege
produce	herstellen
done	gar
special	speziell
note	Note
teach	lehren
final	endgültig
mind	Geist
free	frei
rest	ausruhen
field	Feld
unit	Einheit
wait	abwarten
oh	ach
lead	Blei
fact	Tatsache
behind	hinter
tail	Schwanz
strong	stark
star	Stern
front	Front
cry	schreien
warm	heiß
box	Schachtel
pound	Pfund
beauty	Schönheit
develop	entwickeln
able	fähig
machine	Maschine
minute	Minute
quick	schnell
dark	dunkel
green	grün
town	Stadt
gave	gab
stood	gestanden
noun	Substantiv
ocean	Ozean
interest	Interesse
reach	erreichen
voice	Stimme
cold	kalt
ground	Boden
toward	zu
map	Landkarte
pattern	Muster
slow	langsam
notice	bemerken
west	Westen
serve	dienen
hold	halten
listen	zuhören
step	Stufe
lay	legen
rule	Regel
love	lieben
table	Tisch
simple	einfach
true	wahr
pull	ziehen
less	weniger
govern	regieren
war	Krieg
road	Straße
appear	erscheinen
against	gegen
morning	Morgen
travel	reisen
center	Mitte
sing	singen
better	besser
early	früh
fast	schnell
person	Person
money	Geld
remember	erinnern
during	während
heard	gehört
several	mehrere
am	bin
hundred	hundert
five	fünf
rain	Regen
hour	Stunde
ten	zehn
six	sechs
vowel	Vokal
verb	Verb
reason	Grund
weight	Gewicht
hunt	jagen
pick	pflücken
matter	Materie
vary	variieren
region	Region
represent	darstellen
drop	Tropfen
yet	noch
sail	Segel
settle	siedeln
felt	Filz
square	Quadrat
divide	teilen
bed	Bett
size	Größe
believe	glauben
count	zählen
sudden	plötzlich
cell	Zelle
circle	Kreis
subject	Thema
length	Länge
position	Position
general	General
arm	Arm
include	einschließen
wave	Welle
present	Gegenwart
bear	Bär
perhaps	vielleicht
brother	Bruder
speak	sprechen
grand	großartig
material	Material
energy	Energie
engine	Motor
heavy	schwer
art	Kunst
ride	reiten
wide	breit
ball	Ball
dance	tanzen
heart	Herz
pair	Paar
ice	Eis
egg	Ei
probable	wahrscheinlich
syllable	Silbe
finish	beenden
sign	Zeichen
choose	wählen
trade	Handel
sky	Himmel
sleep	schlafen
race	Rasse
catch	fangen
wish	wünschen
strange	seltsam
edge	Rand
board	Brett
store	Laden
sit	sitzen
fun	Spaß
wild	wild
train	Zug
leg	Bein
past	Vergangenheit
fraction	Bruch
gone	fort
hope	hoffen
exercise	Übung
clothe	kleiden
soft	weich
lone	einsam
prove	beweisen
job	Arbeit
mount	Berg
gas	Gas
visit	besuchen
bright	hell
instrument	Instrument
month	Monat
summer	Sommer
kept	aufbewahren
flower	Blume
forest	Wald
wall	Mauer
window	Fenster
grass	Gras
glass	Glas
happy	glücklich
cow	Kuh
joy	Freude
written	schriftlich
sat	gesessen
weather	Wetter
million	Million
winter	Winter
die	sterben
except	außer
symbol	Symbol
fair	gerecht
suggest	vorschlagen
exact	genau
age	Alter
blow	blasen
row	rudern
join	verbinden
break	brechen
control	Kontrolle
wear	tragen
mouth	Mund
bank	Bank
collect	einsammeln
wire	Draht
fell	fällen
blood	Blut
mix	mischen
clean	sauber
sent	gesendet
trip	Reise
bad	schlecht
office	Büro
team	Mannschaft
save	retten
fit	passen
trouble	Schwierigkeit
equal	gleich
tone	Ton
receive	erhalten
rise	steigen
oil	Öl
least	am wenigsten
brown	braun
shout	schreien
touch	berühren
garden	Garten
yard	Hof
cost	Kosten
melody	Melodie
flow	fließen
lady	Dame
cent	Cent
decimal	dezimal
seed	Samen
wrote	schrieb
lost	verloren
kill	töten
quiet	still
quite	ziemlich
single	ledig
design	Entwurf
skin	Haut
scale	Maßstab
nation	Nation
pay	bezahlen
dress	Kleid
spring	Frühling
broke	pleite
cool	kühl
flat	flach
method	Methode
case	Fall
experiment	Experiment
jump	springen
straight	gerade
section	Abschnitt
observe	beobachten
speed	Geschwindigkeit
key	Schlüssel
bottom	Boden
organ	Organ
ear	Ohr
hole	Loch
stick	Stock
else	sonst
smile	Lächeln
climb	klettern
lot	Los
moment	Moment
poor	arm
loud	laut
milk	Milch
iron	Eisen
crease	Falte
baby	Baby
child	Kind
middle	Mitte
stone	Stein
surprise	Überraschung
cloud	Wolke
lake	See
son	Sohn
consonant	Konsonant
twenty	zwanzig
tiny	winzig
dictionary	Wörterbuch
phrase	Phrase
sense	Sinn
value	Wert
buy	kaufen
safe	sicher
soil	Boden
type	Art
copy	kopieren
view	Ansicht
describe	beschreiben
natural	natürlich
held	gehalten
hill	Hügel
meet	treffen
lie	lügen
consider	erwägen
agree	zustimmen
fight	kämpfen
paragraph	Absatz
beat	schlagen
sand	Sand
result	Ergebnis
push	drücken
raise	heben
eight	acht
either	entweder
silent	still
burn	brennen
cook	kochen
excite	erregen
roll	rollen
law	Gesetz
industry	Industrie
finger	Finger
century	Jahrhundert
floor	Boden
solve	lösen
tall	hoch
bit	Bit
coast	Küste
root	Wurzel
shall	sollen
village	Dorf
third	dritte
metal	Metall
temperature	Temperatur
hair	Haar
cat	Katze
whether	ob
seven	sieben
search	suchen
locate	orten
indicate	anzeigen
ring	Ring
rail	Schiene
process	Prozess
separate	trennen
hit	schlagen
effect	Effekt
noon	Mittag
protect	schützen
supply	liefern
crop	Ernte
insect	Insekt
element	Element
period	Periode
corner	Ecke
history	Geschichte
party	Partei
expect	erwarten
character	Charakter
danger	Gefahr
operate	operieren
practice	Praxis
modern	modern
gentle	sanft
thus	so
provide	versorgen
captain	Kapitän
please	gefallen
student	Student
imagine	sich vorstellen
doctor	Arzt
chair	Stuhl
atom	Atom
caught	fing
spoke	Speiche
rich	reich
radio	Radio
capital	Kapital
fruit	Frucht
bone	Knochen
woman	Frau
human	Mensch
whose	wessen
thick	dick
difficult	schwierig
electric	elektrisch
soldier	Soldat
won’t	wird nicht
dead	tot
crowd	Menge
desert	Wüste
mine	Bergwerk
print	drucken
create	schaffen
send	senden
sharp	scharf
compare	vergleichen
depend	abhängen
lift	Aufzug
rub	reiben
suit	Anzug
thin	dünn
bar	Bar
fear	Angst
guess	raten
wash	waschen
allow	erlauben
spot	Fleck
current	Strom
fresh	frisch
hurry	eilen
chief	Chef
rather	ziemlich
tie	binden
sight	Sehenswürdigkeit
enter	eintreten
string	Schnur
yellow	gelb
arrive	ankommen
bell	Glocke
neighbor	Nachbar
colony	Kolonie
major	Major
clock	Uhr
gun	Gewehr
stream	Bach
tube	Rohr
famous	berühmt
necessary	notwendig
rose	Rose
poem	Gedicht
dollar	Dollar
triangle	Dreieck
corn	Mais
planet	Planet
wing	Flügel
bat	Fledermaus
meat	Fleisch
speech	Rede
motion	Bewegung
station	Station
slave	Sklave
charge	laden
shell	Schale
track	Spur
offer	anbieten
segment	Segment
chord	Akkord
occur	geschehen
support	unterstützen
range	Bereich
spend	ausgeben
market	Markt
post	Pfosten
division	Division
degree	Grad
share	Aktie
duck	Ente
connect	verbinden
proper	richtig
substance	Substanz
parent	Elternteil
drink	trinken
dear	lieb
afraid	ängstlich
enemy	Feind
reply	antworten
instant	Augenblick
master	Herr
original	originell
nature	Natur
populate	bevölkern
favor	bevorzugen
log	Tagebuch
steam	Dampf
neck	Hals
path	Pfad
bread	Brot
shore	Ufer
teeth	Zahn
meant	gemeint
fat	Fett
sheet	Laken
chick	Küken
liquid	Flüssigkeit
glad	froh
dad	Papa
quotient	Quotient
pretty	hübsch
total	ganz
anger	Zorn
smell	Geruch
steel	Stahl
sugar	Zucker
tool	Werkzeug
forward	vorwärts
score	Partitur
evening	Abend
death	Tod
pitch	Pech
season	Jahreszeit
branch	Zweig
solution	Lösung
condition	Zustand
slip	ausrutschen
skill	Fertigkeit
especially	besonders
band	Band
experience	Erfahrung
suffix	Suffix
mass	Masse
discuss	diskutieren
similar	ähnlich
coat	Mantel
feed	füttern
basic	grundlegend
dream	Traum
seat	Sitz
thank	danken
continue	fortsetzen
win	gewinnen
led	angeführt
match	Streichholz
guide	führen
card	Karte
apple	Apfel
nor	noch
huge	riesig
valley	Tal
rope	Seil
double	verdoppeln
sister	Schwester
women	Frauen
bought	eingekauft
fig	Feige
silver	Silber
magnet	Magnet
oxygen	Sauerstoff
term	Trimester
select	auswählen
spread	ausbreiten
chart	Diagramm
level	Niveau
block	Block
particular	besonder
determine	bestimmen
deal	handeln
subtract	subtrahieren
throw	werfen
gather	sammeln
arrange	anordnen
prepare	vorbereiten
stretch	strecken
sell	verkaufen
company	Firma
property	Eigenschaft
claim	Anspruch
wrong	falsch
shoulder	Schulter
event	Ereignis
camp	Lager
broad	breit
repeat	wiederholen
opposite	Gegenteil
require	erfordern
chance	Möglichkeit
shoe	Schuh
shine	scheinen
success	Erfolg
gray	grau
noise	Lärm
invent	erfinden
born	geboren
swim	schwimmen
truck	Lastwagen
shop	Geschäft
cotton	Baumwolle
column	Säule
wife	Ehefrau
nose	Nase
salt	Salz
continent	Kontinent
hat	Hut
plural	Plural
molecule	Molekül
nine	neun
quart	Quart
