back	dos
good	bon
I	je
language	langue
all	tout
whole	entier
every	chaque
part	partie
piece	morceau
at	à
to	à
leave	partir
water	eau
complete	complet
act	agir
add	ajouter
air	air
old	vieux
help	aider
hand	main
like	comme
love	aimer
so	donc
look	regarder
area	région
food	nourriture
go	aller
light	lumière
then	alors
fine	amende
bring	apporter
friend	ami
year	année
animal	animal
again	encore
about	environ
appear	apparaître
call	appeler
name	nom
learn	apprendre
press	presse
after	après
tree	arbre
are	are
money	argent
stop	arrêter
come	venir
happen	arriver
reach	atteindre
enough	assez
wait	attendre
land	terre
no	non
above	au-dessus
before	avant
also	aussi
too	aussi
car	voiture
fall	tomber
other	autre
with	avec
plane	avion
have	avoir
need	besoin
boat	bateau
low	bas
base	base
ship	bateau
build	construire
many	beaucoup
much	beaucoup
beauty	beauté
rock	rocher
well	puits
soon	bientôt
white	blanc
blue	bleu
wood	bois
box	boîte
can	pouvoir
side	côté
move	bouger
end	fin
short	court
sound	son
body	corps
country	pays
able	capable
for	pour
map	carte
cause	cause
that	que
this	ce
hundred	cent
center	centre
certain	certain
sure	sûr
heat	chaleur
room	chambre
field	champ
change	changer
song	chanson
sing	chanter
each	chaque
eye	œil
hot	chaud
warm	chaud
head	tête
road	route
way	manière
check	vérifier
horse	cheval
dog	chien
figure	chiffre
numeral	numéral
object	objet
thing	chose
five	cinq
city	ville
clear	clair
class	classe
order	ordre
as	comme
start	commencer
begin	commencer
how	comment
common	commun
full	plein
drive	conduire
lead	plomb
know	savoir
keep	garder
story	histoire
contain	contenir
force	force
against	contre
correct	correct
right	droit
color	couleur
cut	couper
run	courir
course	cours
cover	couvrir
cry	pleurer
think	penser
grow	grandir
cross	croix
farm	ferme
in	dans
from	de
of	de
early	tôt
decide	décider
state	état
out	dehors
ask	demander
live	vivre
stay	rester
half	moitié
pass	passer
since	depuis
last	dernier
behind	derrière
want	vouloir
draw	dessiner
under	sous
two	deux
second	seconde
front	devant
develop	développer
must	devoir
differ	différer
hard	dur
say	dire
tell	raconter
direct	diriger
talk	parler
record	enregistrer
ten	dix
home	maison
give	donner
down	en bas
school	école
hear	entendre
listen	écouter
write	écrire
she	elle
they	ils
use	usage
still	encore
place	lieu
up	en haut
wind	vent
teach	enseigner
set	ensemble
together	ensemble
between	entre
spell	épeler
test	test
feel	sentir
space	espace
kind	gentil
mind	esprit
try	essayer
east	est
and	et
star	étoile
be	être
stand	être debout
study	étudier
them	eux
example	exemple
plant	planter
make	faire
face	visage
do	faire
fact	fait
family	famille
tire	pneu
close	fermer
fire	feu
girl	fille
river	rivière
time	temps
dark	sombre
work	travail
found	fonder
power	puissance
form	forme
shape	forme
strong	fort
cold	froid
boy	garçon
left	gauche
people	gens
game	jeu
govern	gouverner
rule	règle
big	grand
great	grand
large	grand
free	libre
group	groupe
war	guerre
usual	habituel
high	haut
hour	heure
man	homme
here	ici
idea	idée
thought	pensée
he	il
it	il
island	île
picture	image
show	montrer
interest	intérêt
question	question
ever	jamais
never	jamais
play	jouer
young	jeune
fast	rapide
day	jour
until	jusqu’à
just	juste
there	là
let	laisser
the	le
slow	lent
which	quel
letter	lettre
their	leur
line	ligne
read	lire
list	liste
book	livre
pound	piler
far	loin
distant	lointain
long	long
when	quand
him	lui
moon	lune
my	mon
machine	machine
miss	rater
now	maintenant
but	mais
house	maison
eat	manger
step	pas
walk	marcher
mark	marque
morning	matin
me	me
mean	signifier
better	meilleur
even	même
same	même
self	même
sea	mer
mother	mère
wonder	merveille
measure	mesurer
lay	pondre
put	mettre
south	sud
mile	mille
thousand	mille
minute	minute
less	moins
world	monde
mountain	montagne
watch	montre
point	point
word	mot
fly	voler
multiply	multiplier
music	musique
snow	neige
new	nouveau
black	noir
noun	nom
number	nombre
north	nord
note	note
our	notre
us	nous
we	nous
night	nuit
get	obtenir
west	ouest
ocean	océan
bird	oiseau
gold	or
or	ou
where	où
yes	oui
open	ouvrir
page	page
paper	papier
by	par
through	par
seem	sembler
among	parmi
foot	pied
fish	poisson
paint	peinture
during	pendant
father	père
person	personne
little	petit
small	petit
few	peu
sentence	phrase
plain	plaine
plan	plan
rain	pluie
more	plus
several	plusieurs
port	port
door	porte
carry	porter
own	posséder
possible	possible
inch	pouce
why	pourquoi
may	pouvoir
first	premier
take	prendre
near	près
ready	prêt
main	principal
problem	problème
next	prochain
produce	produire
product	produit
deep	profond
four	quatre
than	que
what	quoi
any	quelconque
some	quelques
tail	queue
who	qui
quick	rapide
real	réel
notice	remarquer
fill	remplir
answer	répondre
rest	se reposer
nothing	rien
laugh	rire
king	roi
round	rond
wheel	roue
red	rouge
street	rue
her	son
his	son
saw	scie
science	science
dry	sec
week	semaine
remember	se souvenir
serve	servir
only	seulement
if	si
simple	simple
six	six
care	soin
earth	terre
ground	terre
sun	soleil
top	sommet
often	souvent
special	spécial
follow	suivre
on	sur
surface	surface
system	système
table	table
late	tard
such	tel
hold	tenir
will	volonté
pull	tirer
you	vous
your	votre
always	toujours
turn	tourner
very	très
three	trois
find	trouver
one	un
once	une fois
unit	unité
verb	verbe
true	vrai
toward	vers
green	vert
life	vie
town	ville
see	voir
voice	voix
travel	voyager
vowel	voyelle
search	chercher
choose	choisir
pick	cueillir
select	choisir
share	partager
party	fête
desert	désert
fell	abattre
chord	accord
bear	ours
charge	charge
buy	acheter
finish	finir
steel	acier
current	courant
case	cas
matter	matière
age	âge
wave	vague
sharp	tranchant
wing	aile
magnet	aimant
thus	ainsi
feed	nourrir
match	allumette
fun	amusement
corner	coin
ring	bague
flat	plat
prepare	préparer
support	soutien
silver	argent
arm	bras
arrange	arranger
arrive	arriver
occur	arriver
art	art
lift	ascenseur
season	saison
quite	assez
atom	atome
tie	attacher
expect	attendre
catch	attraper
forward	en avant
view	vue
fight	se battre
ball	ballon
band	bande
bank	banque
bar	bar
bottom	fond
stick	bâton
beat	battre
hit	frapper
pretty	joli
baby	bébé
bit	bit
strange	étrange
block	bloquer
drink	boire
forest	forêt
edge	bord
shore	rivage
mouth	bouche
shop	boutique
store	magasin
branch	branche
bright	brillant
shine	briller
break	casser
noise	bruit
burn	brûler
brown	brun
log	bûche
office	bureau
present	présent
stone	pierre
quiet	calme
truck	camion
camp	camp
duck	canard
gun	fusil
skill	habileté
captain	capitaine
capital	capital
character	caractère
shell	coquille
square	carré
card	carte
reason	raison
famous	célèbre
single	célibataire
cell	cellule
cent	centime
middle	milieu
circle	cercle
meat	viande
chair	chaise
seat	siège
chance	chance
hat	chapeau
hunt	chasser
cat	chat
shoe	chaussure
bat	chauve-souris
chief	chef
path	chemin
dear	cher
ride	chevaucher
hair	cheveux
sky	ciel
key	clé
bell	cloche
heart	cœur
safe	coffre-fort
anger	colère
collect	rassembler
hill	colline
colony	colonie
column	colonne
major	majeur
trade	commerce
company	compagnie
compare	comparer
suit	complet
include	inclure
count	compter
condition	condition
consider	considérer
consonant	consonne
glad	content
happy	heureux
continent	continent
continue	continuer
opposite	opposé
control	contrôle
copy	copier
corn	maïs
rope	corde
string	corde
coast	côte
cotton	coton
neck	cou
flow	couler
blow	souffler
yard	cour
stream	ruisseau
race	race
cost	coûter
fear	peur
create	créer
shout	crier
believe	croire
gather	rassembler
cook	cuire
lady	dame
danger	danger
dance	danser
die	mourir
death	mort
describe	décrire
degree	degré
depend	dépendre
spend	dépenser
wish	souhaiter
determine	déterminer
guess	deviner
dictionary	dictionnaire
difficult	difficile
trouble	problème
speech	discours
discuss	discuter
divide	diviser
division	division
doctor	médecin
finger	doigt
dollar	dollar
sleep	dormir
double	double
gentle	doux
soft	mou
sheet	feuille
law	loi
straight	droit
scale	écaille
save	sauver
skin	peau
effect	effet
equal	égal
electric	électrique
element	élément
student	étudiant
raise	élever
job	travail
yet	encore
energy	énergie
child	enfant
enemy	ennemi
huge	énorme
enter	entrer
send	envoyer
thick	épais
shoulder	épaule
ear	oreille
wife	épouse
team	équipe
climb	grimper
slave	esclave
hope	espoir
gas	gaz
floor	plancher
spread	étendre
summer	été
stretch	étendre
surprise	surprendre
sit	s’asseoir
event	événement
exact	exact
excite	exciter
exercise	exercice
require	exiger
experience	expérience
experiment	expérience
wrong	incorrect
woman	femme
window	fenêtre
iron	fer
felt	feutre
fig	figue
wire	fil
son	fils
smell	odeur
flower	fleur
fair	juste
loud	fort
crowd	foule
provide	fournir
supply	offre
fraction	fraction
cool	refroidir
fresh	frais
brother	frère
rub	frotter
fruit	fruit
win	gagner
station	gare
general	général
type	type
ice	glace
slip	glisser
drop	goutte
seed	semence
fat	graisse
tall	grand
size	taille
gray	gris
guide	guide
clothe	habiller
dress	robe
hurry	se dépêcher
grass	herbe
history	histoire
winter	hiver
human	humain
oil	huile
eight	huit
imagine	imaginer
print	imprimer
indicate	indiquer
industry	industrie
insect	insecte
instant	instant
moment	moment
instrument	instrument
tool	outil
invent	inventer
crop	jabot
leg	jambe
garden	jardin
yellow	jaune
throw	jeter
joy	joie
connect	relier
join	joindre
lake	lac
allow	permettre
milk	lait
broad	large
wide	large
wash	laver
rise	monter
row	ramer
liquid	liquide
bed	lit
engine	moteur
phrase	locution
length	longueur
heavy	lourd
thin	mince
master	maître
bad	mauvais
coat	manteau
market	marché
mass	masse
material	matériel
mix	mélanger
melody	mélodie
lie	mentir
metal	métal
method	méthode
noon	midi
million	million
mine	mine
tiny	minuscule
modern	moderne
month	mois
molecule	molécule
mount	monter
clock	horloge
dead	mort
motion	mouvement
wall	mur
swim	nager
nation	nation
nature	nature
natural	naturel
sail	voile
born	né
necessary	nécessaire
clean	propre
nine	neuf
nose	nez
level	niveau
cloud	nuage
observe	observer
egg	œuf
offer	offrir
operate	opérer
organ	organe
original	original
bone	os
either	ou
oxygen	oxygène
bread	pain
pair	paire
dad	papa
paragraph	paragraphe
similar	semblable
parent	parent
speak	parler
particular	particulier
past	passé
poor	pauvre
pay	payer
lost	perdu
period	période
perhaps	peut-être
track	piste
please	plaire
board	planche
planet	planète
plural	pluriel
rather	plutôt
poem	poème
weight	poids
apple	pomme
wear	porter
position	position
post	poteau
push	pousser
chick	poussin
practice	pratique
spring	printemps
probable	probable
process	processus
suggest	suggérer
property	propriété
protect	protéger
prove	prouver
quotient	quotient
root	racine
radio	radio
speed	vitesse
spoke	rayon
receive	recevoir
region	région
thank	remercier
meet	rencontrer
repeat	répéter
reply	répondre
represent	représenter
solve	résoudre
result	résultat
dream	rêve
rich	riche
rose	rose
roll	rouler
sand	sable
salt	sel
soil	terre
blood	sang
except	sauf
jump	sauter
wild	sauvage
section	section
segment	segment
sense	sens
separate	séparer
seven	sept
whether	si
century	siècle
sign	signe
silent	silencieux
sister	sœur
evening	soir
soldier	soldat
solution	solution
sudden	soudain
smile	sourire
subtract	soustraire
substance	substance
success	succès
sugar	sucre
suffix	suffixe
subject	sujet
especially	surtout
syllable	syllabe
symbol	symbole
spot	tache
temperature	température
weather	temps
term	terme
third	troisième
tone	ton
total	total
touch	toucher
train	train
triangle	triangle
hole	trou
tube	tube
kill	tuer
cow	vache
value	valeur
valley	vallée
steam	vapeur
vary	varier
sell	vendre
glass	verre
village	village
twenty	vingt
visit	visiter
neighbor	voisin
trip	voyage
sight	vue
agree	être d’accord
